XXXXXXXXX XXXXXXXXXXXXXXXXXXX
XXXXXXXXX XXXXXXXXXXXXXXXXXXX
XXXXXXXXX      XXXXXXXXXXXXXX
XXXXXXXXXXXXXX XXXXXXXXXXXXXX
XXXXXXXXXXXXXX XXXXXXXXXXXXXX
XXXXXXXXXXXXXX XXXXXXXXXXXXXX
XXXXXXXXX      XXXXXXXXXXXXXX
XXXXXXXXXXX  XXXXXXXXXXXXXXXX
XXXXXXXXXXX  XXXXXXXXXXXXXXXX
XXXXXXXXXXX  XXXXXXXXXXXXXXXX
XXXXXXXXX    XXXXXXXXXXXXXXXX
XXXXXXXXX XXXXXXXXXXXXXXXXXXX
XXXXXXXXX XXXXXXXXXXXXXXXXXXX
XXXXXXXXX XXXXXXXXXXXXXXXXXXX
XXXXXXXXX XXXXXXXXXXXXXXXXXXX
XXXXXXXXX XXXXXXXXXXXXXXXXXXX
XXXXXXXXX XXXXXXXXXXXXXXXXXXX
XXXXXXXXX XXXXXXXXXXXXXXXXXXX
XXXXXXXXX XXXXXXXXXXXXXXXXXXX
XXXXXXXXX XXXXXXXXXXXXXXXXXXX
XXXXXXXXX XXXXXXXXXXXXXXXXXXX
XXXXXXXXX XXXXXXXXXXXXXXXXXXX
XXXXXXXXX XXXXXXXXXXXXXXXXXXX
XXXXXXXXX XXXXXXXXXXXXXXXXXXX
XXXXXXXXX XXXXXXXXXXXXXXXXXXX
XXXXXXXXX XXXXXXXXXXXXXXXXXXX
XXXXXXXXX XXXXXXXXXXXXXXXXXXX
XXXXXXXXX XXXXXXXXXXXXXXXXXXX
